##########################################################################
##########################################################################
##......................................................................##
##......................................................................##
##...........########...................................................##
##...............................................@......................##
##....................#.................................................##
##....................##############..#################.................##
##....................#.................................................##
##....................#.................................................##
##....................#.................................................##
##......................................................................##
##....................#.................................................##
##....................#..............#######............................##
##....................#....................#............................##
##.......##############....................#............................##
##....................#..............#.....#............................##
##....................#..............#######............................##
##....................#.................................................##
##....................#.................................................##
##......................................................................##
##......................................................................##
##....................#.................................................##
##....................#.................................................##
###########..##########.................................................##
##...................................#######################............##
##......................................................................##
##......................................................................##
##......................................................................##
##......................................................................##
##......................................................................##
##..............#.......................................................##
##..............#.......................................................##
##..............#.......................................................##
##..............#.......................................................##
##..............#.......................................................##
##..............#.......................................................##
##.....................................###################..##############
##.....................................#................................##
##.....................................#................................##
##.....................................#................................##
##..............#...........................................Z...........##
##..............#.......................................................##
##......................................Z...............................##
##......................................................................##
##########################################################################
##########################################################################