#########
#ZZZZZZZ#
#ZZZZZZZ#
#ZZZZZZZ#
#.......#
#.......#
#.......#
#.......#
#.......#
#.......#
#.......#
#.......#
#.......#
#.......#
#.......#
#.......#
#.......#
#.......#
#.......#
#.......#
#.......#
#.......#
#.......#
#.......#
#.......#
#.......#
#.......#
#.......#
#.......#
#.......#
#.......#
#.......#
#.......#
#.......#
#.......#
#.......#
#.......#
#......@#
#########