############################################################
#                    #                                     #
#                    #                                     #
#           ##########                                     #
#                    #                          @          #
#                    #                                     #
#                    #################################     #
#                    #                                     #
#                    #                                     #
#                    #                                     #
#                    #                                     #
#                    #                                     #
#                    #              #######                #
#                    #                    #                #
#       ##############                    #                #
#                    #              #     #                #
#                    #              #######                #
#                    #                                     #
#                    #                                     #
#                                                          #
#                                                          #
#                    #                                     #
#                    #                                     #
######################                                     #
#                                   ########################
#                                                          #
#                                                          #
#                                                          #
#                                                          #
#                                                          #
############################################################