############################################################
#....................#.....................................#
#....................#.....................................#
#...........##########.....................................#
#....................#..........................@..........#
#....................#.....................................#
#....................#################################.....#
#....................#.....................................#
#....................#.....................................#
#....................#.....................................#
#....................#.....................................#
#....................#.....................................#
#....................#..............#######................#
#....................#....................#................#
#.......##############....................#................#
#....................#..............#.....#................#
#....................#..............#######................#
#....................#.....................................#
#....................#.....................................#
#..........................................................#
#..........................................................#
#....................#.....................................#
#....................#.....................................#
######################.....................................#
#...................................########################
#..........................................................#
#..........................................................#
#..........................................................#
#....................Z.....................................#
#..........................................................#
############################################################