########################################################################
#....................#.................................................#
#....................#.................................................#
#...........##########.................................................#
#....................#..........................@......................#
#....................#.................................................#
#....................#################################.................#
#....................#.................................................#
#....................#.................................................#
#....................#.................................................#
#....................#.................................................#
#....................#.................................................#
#....................#..............#######............................#
#....................#....................#............................#
#.......##############....................#............................#
#....................#..............#.....#............................#
#....................#..............#######............................#
#....................#.................................................#
#....................#.................................................#
#......................................................................#
#......................................................................#
#....................#.................................................#
#....................#.................................................#
######################.................................................#
#...................................#######################............#
#......................................................................#
#......................................................................#
#......................................................................#
#....................Z.................................................#
#......................................................................#
#......................................................................#
#......................................................................#
#......................................................................#
#......................................................................#
#......................................................................#
#......................................................................#
#......................................................................#
#......................................................................#
#......................................................................#
#......................................................................#
#......................................................................#
#......................................................................#
#......................................................................#
#......................................................................#
#......................................................................#
#......................................................................#
#......................................................................#
#......................................................................#
#......................................................................#
#......................................................................#
#......................................................................#
#......................................................................#
#......................................................................#
#......................................................................#
#......................................................................#
#......................................................................#
#......................................................................#
#......................................................................#
########################################################################